    
    NO    ./textures/ceil1_3.png
SO ./textures/w33_5.png
WE ./textures/w112_1.png
EA       ./textures/slime09.png

C  255,30,0
    F   220,100,0


    1111111111111111111111111
    1000000000110000000000001
    1011000001110000000000001
    1001000000000000000000001111111111
11111111111111011000001110000000000001
10000000001100000111011111111111111111
11110111111111011000000010001
11110111111111011101010010001
1100000011010101110000010001
10000000000000001100000010001
10000000000000001101010000001
110000011101010111110111100111
11110111 1110101 101111010001
11111111 1111111 111111111111