NO ./textures/NO_wall.png
SO ./textures/SO_wall.png
WE ./textures/WE_wall.png
EA ./textures/EA.png

F 123,111,123
C 000,000,250

11111111111111111
10000000000000001
10000000001111111
100000000000N1
10000000001000001
11111111111111111
