NO ./textures/colorstone.xpm
SO ./textures/bluestone.xpm
WE ./textures/greystone.xpm
EA ./textures/wood.xpm

F 255,248,220
C 135,206,250

11111111111111111
10000000000000001
10000000001111111
100000000010N0001
1000000000100000
11111111111111111
