NO ./textures/colorstone.xpm
SO ./textures/bluestone.xpm
WE ./textures/greystone.xpm
EA ./textures/wood.xpm

F 255,248,220
C 135,206,250

11111111111111111
10000000000000001
10000000001111111
10000000000N00001
10000000001000001
11111111111111111
